{
    "map_neg": [[[9, 10, 8, -3, -2, -4, -3, -2, -4, -3, -2, -4, 0, 0, 0, 0, 0, 0, 0, 0, 0, 0, 0, 0],
                 [6, 6, -2, -2, -2, -2, -2, -2, 0, 0, 0, 0, 0, 0, 0, 0, 0, 0, 0, 0, 0, 0, 0, 0]],
                [[0, 0, 0, 0, 0, 0, 0, 0, 0, 0, 0, 0, 3, 4, 2, 3, 4, 2, 3, 4, 2, -9, -8, -10],
                 [0, 0, 0, 0, 0, 0, 0, 0, 0, 0, 0, 0, 0, 0, 0, 0, 2, 2, 2, 2, 2, 2, -6, -6]],
                [[14, 12, 10, 0, 0, 0, 0, 0, 0, -7, -9, -11, 11, 9, 7, 0, 0, 0, 0, 0, 0, -10, -12, -14],
                 [9, 7, 0, 0, 0, 0, 0, 0, 9, 7, 0, 0, 0, 0, -13, -15, -1, -3, 0, 0, 0, 0, 0, 0]],
                [[0, 0, 0, 5, 3, 1, 14, 12, 10, 0, 0, 0, 0, 0, 0, -10, -12, -14, -1, -3, -5, 0, 0, 0],
                 [0, 0, 0, 0, 9, 7, 0, 0, 0, 0, -5, -7, 9, 7, 0, 0, 0, 0, 0, 0, -9, -11, 0, 0]],
                [[4, 2, 3, 13, 11, 12, 0, 0, 0, 0, 0, 0, -11, -13, -12, -2, -4, -3, 0, 0, 0, 0, 0, 0],
                 [0, 0, 8, 8, 0, 0, 0, 0, -6, -6, 8, 8, 0, 0, 0, 0, 0, 0, -10, -10, 0, 0, 0, 0]],
                [[0, 0, 0, 0, 0, 0, 4, 2, 3, 13, 11, 12, 0, 0, 0, 0, 0, 0, -11, -13, -12, -2, -4, -3],
                 [0, 0, 0, 0, 0, 0, 8, 8, 0, 0, 0, 0, -6, -6, 8, 8, 0, 0, 0, 0, 0, 0, -10, -10]]],
    "map_pos": [[[3, 4, 2, 3, 4, 2, 3, 4, 2, -9, -8, -10, 0, 0, 0, 0, 0, 0, 0, 0, 0, 0, 0, 0],
                 [2, 2, 2, 2, 2, 2, -6, -6, 0, 0, 0, 0, 0, 0, 0, 0, 0, 0, 0, 0, 0, 0, 0, 0]],
                [[0, 0, 0, 0, 0, 0, 0, 0, 0, 0, 0, 0, 9, 10, 8, -3, -2, -4, -3, -2, -4, -3, -2, -4],
                 [0, 0, 0, 0, 0, 0, 0, 0, 0, 0, 0, 0, 0, 0, 0, 0, 6, 6, -2, -2, -2, -2, -2, -2]],
                [[11, 9, 7, 0, 0, 0, 0, 0, 0, 14, 12, 10, -10, -12, -14, 0, 0, 0, 0, 0, 0, -7, -9, -11],
                 [15, 13, 0, 0, 0, 0, 0, 0, -7, -9, 0, 0, 0, 0, 3, 1, -7, -9, 0, 0, 0, 0, 0, 0]],
                [[0, 0, 0, 14, 12, 10, -1, -3, -5, 0, 0, 0, 0, 0, 0, 5, 3, 1, -10, -12, -14, 0, 0, 0],
                 [0, 0, 0, 0, 7, 5, 0, 0, 0, 0, 11, 9, -7, -9, 0, 0, 0, 0, 0, 0, -7, -9, 0, 0]],
                [[13, 11, 12, -2, -4, -3, 0, 0, 0, 0, 0, 0, 4, 2, 3, -11, -13, -12, 0, 0, 0, 0, 0, 0],
                 [0, 0, 6, 6, 0, 0, 0, 0, 10, 10, -8, -8, 0, 0, 0, 0, 0, 0, -8, -8, 0, 0, 0, 0]],
                [[0, 0, 0, 0, 0, 0, 13, 11, 12, -2, -4, -3, 0, 0, 0, 0, 0, 0, 4, 2, 3, -11, -13, -12],
                 [0, 0, 0, 0, 0, 0, 6, 6, 0, 0, 0, 0, 10, 10, -8, -8, 0, 0, 0, 0, 0, 0, -8, -8]]],
     "corner_633maps": [[[0, 0, 0], [4, 0, 2], [2, 2, 0]],
                        [[0, 2, 0], [3, 0, 0], [4, 2, 2]],
                        [[0, 2, 2], [5, 2, 0], [3, 0, 2]],
                        [[0, 0, 2], [2, 2, 2], [5, 0, 0]],
                        [[1, 0, 2], [2, 0, 0], [4, 0, 0]],
                        [[1, 2, 2], [4, 2, 0], [3, 2, 0]],
                        [[1, 2, 0], [3, 2, 2], [5, 2, 2]],
                        [[1, 0, 0], [5, 0, 2], [2, 0, 2]]],
     "side_633maps": [[[0, 0, 1], [2, 2, 1]],
                      [[0, 1, 0], [4, 1, 2]],
                      [[0, 2, 1], [3, 0, 1]],
                      [[0, 1, 2], [5, 1, 0]],
                      [[2, 1, 0], [4, 0, 1]],
                      [[3, 1, 0], [4, 2, 1]],
                      [[3, 1, 2], [5, 2, 1]],
                      [[2, 1, 2], [5, 0, 1]],
                      [[1, 0, 1], [2, 0, 1]],
                      [[1, 1, 2], [4, 1, 0]],
                      [[1, 2, 1], [3, 2, 1]],
                      [[1, 1, 0], [5, 1, 2]]]
}
